Denis Oliver Kropp
5
----*********----
--***++ 0 ++***--
--*+++++ +++++*--
-**+++*+++*+++**-
**++***+++***++**
* ++*+++ +++*++ *
*2 ++++ 4 ++++ 3*
* ++*+++ +++*++ *
**++***+++***++**
-**+++*+++*+++**-
--*+++++ +++++*--
--***++ 1 ++***--
----*********----
