Andreas Hundt
8
*****************
*0 RRRRRRRRRRR 2*
* *R*R*R*R*R*R* *
*RRRR4 RRR 5RRRR*
*R*R* *R*R* *R*R*
*RRRRRRRRRRRRRRR*
*R*R*R*R*R*R*R*R*
*RRRRRRRRRRRRRRR*
*R*R* *R*R* *R*R*
*RRRR6 RRR 7RRRR*
* *R*R*R*R*R*R* *
*3 RRRRRRRRRRR 1*
*****************
