Ivar
4
*****************
*1 ++-------++ 0*
* +++++++++++++ *
*+++++vvvvv+++++*
*---+>SSSSS<+---*
*---+>SSSSS<+---*
*---+>SSSSS<+---*
*---+>SSSSS<+---*
*---+>SSSSS<+---*
*+++++^^^^^+++++*
* +++++++++++++ *
*3 ++-------++ 2*
*****************
