Denis Oliver Kropp
4
*******-*-*******
*0 +RRR*v*RRR+ 2*
* +RRRRRRRRRRR+ *
*+RRRR**+**RRRR+*
*RR*RRR+++RRR*RR*
-*R*+++++++++*R*-
*>R+++++o+++++R<*
-*R*+++++++++*R*-
*RR*RRR+++RRR*RR*
*+RRRR**+**RRRR+*
* +RRRRRRRRRRR+ *
*3 +RRR*^*RRR+ 1*
*******-*-*******
