Denis Oliver Kropp
4
********-********
*0 +++++*+++++ 2*
* *o+o+o+o+o+o* *
*++ + + + + + ++*
*+++++++++++++++*
*+++++++++++++++*
-*+o*o*o*o*o*o+*-
*+++++++++++++++*
*+++++++++++++++*
*++ + + + + + ++*
* *o+o+o+o+o+o* *
*3 +++++*+++++ 1*
********-********
