mass
7
*****************
*+  +++ 5v+++  +*
* 0+++++v+++++3 *
* +++++v+++++++ *
*+++++v+++++++++*
*++++++<+v++++++*
*+++++++*+++++++*
*4+++++^+>+++++1*
*  +++++++^+++  *
*+ *+++++^+++* +*
*++  2++^++6  ++*
*++++  ^++  ++++*
*****************
