Andreas Hundt
8
*****************
*+++++++++++++++*
*+*+*+*+*+*+*+*+*
*+++0       2+++*
*+*+*       *+*+*
*+++7       4+++*
*+*+*       *+*+*
*+++5       6+++*
*+*+*       *+*+*
*+++3       1+++*
*+*+*+*+*+*+*+*+*
*+++++++++++++++*
*****************
