Ivar
4
*****************
*0>     v     <2*
* +----- -----+ *
*+--+++- -+++--+*
*+-++++- -++++-+*
*+-++++- -++++-+*
*+-++++   ++++-+*
*+-++++- -++++-+*
*+-++++- -++++-+*
*+--+++- -+++--+*
* +----- -----+ *
*3>     ^     <1*
*****************
