Ivar

8
***6*********7***
*ooooooooooooooo*
*o+*+++++++++*+o*
1o*+++++++++++*o0
*o+++ ***** +++o*
*o++ *-----* ++o*
*o++*-------*++o*
*o++ *-----* ++o*
*o+++ ***** +++o*
3o*+++++++++++*o2
*o+*+++++++++*+o*
*ooooooooooooooo*
***5*********4***
