Ivar
8
-----------------
-  6+++++++++5  -
- SSSSSSSSSSSSS -
-0S+++++++++++S2-
-+S+---------+S+-
-+S+---------+S+-
-+S+---------+S+-
-+S+---------+S+-
-+S+---------+S+-
-3S+++++++++++S1-
- SSSSSSSSSSSSS -
-  4+++++++++7  -
-----------------
