Ivar
4
*****************
*v<<<<<<<<<<<<<<*
*v0+++++++++++2^*
*v+>>>>>>>>>>v+^*
*v+^++++ ++++v+^*
*v+^+++   +++v+^*
*v+^++  +  ++v+^*
*v+^+++   +++v+^*
*v+^++++ ++++v+^*
*v+^<<<<<<<<<<+^*
*v1+++++++++++3^*
*>>>>>>>>>>>>>>^*
*****************
