Denis Oliver Kropp
4
-----------------
-----------------
-----------------
*****************
*RR*RRRRRRRRR*RR*
*R RRRRRRR RRRRR*
*0 R*R 2*3 R*R 1*
*RRRRR RRRRRRR R*
*RR*RRRRRRRRR*RR*
*****************
-----------------
-----------------
-----------------
