Andreas Hundt
8
*****************
*0 + + +*+ + + 2*
* + + +6  + + + *
*+ + + + + + + +*
* + + + * + + + *
*+ + + +*+ +5+ +*
***  *******  ***
*+ +4+ +*+ + + +*
* + + + * + + + *
*+ + + + + + + +*
* + + +  7+ + + *
*3 + + +*+ + + 1*
*****************
