Clanner
4
*****************
*0 +++*+++*+++ 2*
* ++++*+++*++++ *
*+***+*+++*+***+*
*+*v+++   +++v*+*
***S+*******+S***
*SS>SSSSoSSSS<SS*
***S+*******+S***
*+*^+++   +++^*+*
*+***+*+++*+***+*
* ++++*+++*++++ *
*3 +++*+++*+++ 1*
*****************
