Andreas Hundt
8
0 RRRRRRRRRRRRR 1
 *R*R*R*R*R*R*R* 
RRRRRRRRRRRRRRRRR
R*R* *R*R*R* *R*R
RRR 4RRRRRRR5 RRR
R*R*R*R*R*R*R*R*R
RRRRRRRRRRRRRRRRR
R*R*R*R*R*R*R*R*R
RRR 7RRRRRRR6 RRR
R*R* *R*R*R* *R*R
RRRRRRRRRRRRRRRRR
 *R*R*R*R*R*R*R* 
2 RRRRRRRRRRRRR 3
