Ivar
4
*****************
*0 v+++v+++v++ 2*
* *SSS*S*S*S*S* *
*+S           S<*
*+* +++++++++ *+*
*>S +++++++++ S+*
*+* ++++-++++ *+*
*+S +++++++++ S<*
*+* +++++++++ *+*
*>S           S+*
* *S*S*S*S*S*S* *
*3 ++^+++^+++^ 1*
*****************
