Denis Oliver Kropp
4
-***************-
-*+++++0v +++++*-
-*++++++ ++++++*-
-*++****+****++*-
-*++*--*S*--*++*-
-* +****S****+3*-
-*> +SSSSSSS+ <*-
-*2+****S****+ *-
-*++*--*S*--*++*-
-*++****+****++*-
-*++++++ ++++++*-
-*+++++ ^1+++++*-
-***************-
