Clanner
4
--***-*-*-*-***--
-*  0* * * *2  *-
*v* *       * *v*
*++++ ***** ++++*
*+*+* +++++ *+*+*
*>+++ +++++ +++<*
*+*+*       *+*+*
*>+++ +++++ +++<*
*+*+* +++++ *+*+*
*++++ ***** ++++*
*^* *       * *^*
-*  3* * * *1  *-
--***-*-*-*-***--
