Andreas Hundt
4
*****************
*0 R-RRR-RRR-R 1*
* -R-R-R-R-R-R- *
*R-RRR-RRR-RRR-R*
*------- -------*
*               *
*+++++++++++++++*
*               *
*------- -------*
*R-RRR-RRR-RRR-R*
* -R-R-R-R-R-R- *
*2 R-RRR-RRR-R 3*
*****************
