Denis Oliver Kropp
4
*****************
*+++++++++++++++*
*++0+++++++++3++*
*++   +++++   ++*
*+++++++++++++++*
*+++++++*+++++++*
*++++++***++++++*
*+++++++*+++++++*
*+++++++++++++++*
*++   +++++   ++*
*++2+++++++++1++*
*+++++++++++++++*
*****************
