Andreas Hundt
6
-***-***-***-***-
*0  *RRR*RRR*  2*
*   +RRR+RRR+   *
*   *RRR*RRR*   *
-***-*+*-*+*-***-
*   *RRR*RRR*   *
*4  +RRR+RRR+  5*
*   *RRR*RRR*   *
-***-*+*-*+*-***-
*   *RRR*RRR*   *
*   +RRR+RRR+   *
*3  *RRR*RRR*  1*
-***-***-***-***-
