Andreas Hundt
4
*****************
*RRRRRR*2  *RRRR*
*RRRRR<*v  *RRRR*
*RRRRRR* ***RRRR*
******++>++RR^RR*
*    *+++++******
*  0> ^+++v <1  *
******+++++*    *
*RRvRR++<++******
*RRRR*** *RRRRRR*
*RRRR*  ^*>RRRRR*
*RRRR*  3*RRRRRR*
*****************
