Clanner
4
*****************
*vSS<RRR*RRRvSS<*
*S**RRRR*RRRS**S*
*S*RRRRRRRRRSR*S*
*SRRRR *** RSRRS*
*SRRRR 0*2 RSRRS*
*>SSv*******>SS^*
*SRRSR 3*1 RRRRS*
*SRRSR *** RRRRS*
*S*RSRRRRRRRRR*S*
*S**SRRR*RRRR**S*
*^SS<RRR*RRR>SS^*
*****************
