Andreas Hundt
8
-----------------
-***************-
-*0 RRRRRRRRR 2*-
-* *R* *R* *R* *-
-*RRR 6RRR7 RRR*-
-*R*R*R*R*R*R*R*-
-*RRRRRRRRRRRRR*-
-*R*R*R*R*R*R*R*-
-*RRR 4RRR5 RRR*-
-* *R* *R* *R* *-
-*3  RRRRRRRR 1*-
-***************-
-----------------
