Denis Oliver Kropp
4
*****************
*0 +++++++++++ 2*
* +++++ * +++++ *
*+***** * *****+*
*++++++ * ++++++*
*++++++ * ++++++*
*++++++ * ++++++*
*++++++ * ++++++*
*++++++ * ++++++*
*+***** * *****+*
* +++++ * +++++ *
*3 +++++++++++ 1*
*****************
