Andreas Hundt
4
-----------------
---***********---
---*0 +RRR+ 2*---
---* *R*R*R* *---
---*+RRRRRRR+*---
---*R*R*R*R*R*---
---*RRRRRRRRR*---
---*R*R*R*R*R*---
---*+RRRRRRR+*---
---* *R*R*R* *---
---*3 +RRR+ 1*---
---***********---
-----------------
