Denis Oliver Kropp
8
--***-------***--
-**0*********4**-
-*   +++++++   *-
*****+++++++*****
*7 *+++++++++* 2*
**  +++++++++  **
-****+++++++****-
**  +++++++++  **
*3 *+++++++++* 6*
*****+++++++*****
-*   +++++++   *-
-**5*********1**-
--***-------***--
